





            11111111111111111111111111
            1P000000000000000000000001
            10000000000000000011111111
            10000000000000000000000001
11111111111111111111111111111000000001
10000000000000000000000001111111111111
10000000000000000000000000000000000001
10000000000000000000000001111111111111
10000000000011111111100001
10000000000010000000100001
10000000000010000000100001
10000000000011111111100001
10000000000000000000000001
10000000000000000000000001
10000000000000000000000001
11111111111111111111111111